1,1,1,1,1,1,1,1,1,1,1,1,1,1,1,1,1,1,1,1,1,1,1,1,1,1,4,4,4,4,4,1,1,1,1,1,1,1,1,1
1,1,1,1,1,1,1,1,1,1,1,1,1,1,1,1,1,1,1,1,1,1,1,1,1,1,4,4,4,4,4,1,1,1,1,1,1,1,1,1
1,1,2,1,1,1,1,1,1,1,1,1,4,4,1,1,1,1,6,6,1,1,1,1,1,1,-1,-1,4,4,1,1,1,1,1,1,1,1,1,1
1,1,1,1,1,1,1,1,1,-1,1,1,4,4,1,1,1,6,6,6,1,1,5,5,5,5,1,-1,-1,-1,-1,-1,1,1,1,1,1,1,1,1
1,1,1,1,1,1,1,1,1,-1,1,4,4,4,1,1,6,6,1,1,1,5,5,5,5,5,5,5,1,1,1,-1,-1,1,1,1,1,1,1,1
1,1,1,1,1,1,1,1,1,-1,1,4,4,4,1,6,6,1,1,1,5,5,5,5,5,5,5,5,5,1,1,1,-1,-1,1,1,1,1,1,1
1,1,1,1,1,1,-1,-1,-1,-1,4,4,4,1,6,6,1,1,1,1,1,5,5,5,5,5,5,5,5,1,1,1,1,-1,1,1,1,1,1,1
1,1,1,1,1,1,-1,1,1,1,4,4,1,1,6,1,1,1,1,1,5,5,5,5,5,5,5,5,5,1,1,1,1,-1,1,1,1,1,1,1
1,1,1,1,1,1,-1,1,1,4,4,1,1,6,6,1,4,4,1,1,1,5,5,5,5,5,5,5,5,5,1,1,1,-1,-1,1,1,1,1,1
1,1,1,1,1,1,-1,1,1,4,4,1,6,6,1,1,4,4,1,1,1,5,5,5,5,5,5,5,5,5,1,1,1,1,-1,-1,1,1,1,1
1,1,-1,-1,-1,-1,-1,1,4,4,4,6,6,4,4,4,4,4,4,1,1,1,5,5,5,5,5,5,5,5,5,1,1,1,1,-1,1,1,1,1
1,1,1,1,1,1,1,4,4,4,6,6,1,1,4,4,4,4,4,1,1,1,1,5,5,5,5,5,5,5,5,1,1,1,1,-1,1,1,1,6
1,1,1,1,4,4,4,4,1,6,6,1,1,1,4,4,4,4,4,1,1,1,1,5,5,5,5,5,5,5,1,1,1,1,1,-1,1,1,6,6
1,1,1,4,4,4,4,1,1,6,6,1,1,1,4,4,4,4,4,1,1,1,5,5,5,5,5,5,5,1,1,1,1,1,1,-1,1,1,6,6
1,1,1,1,1,1,1,1,6,6,6,6,1,1,4,4,4,4,4,1,1,1,5,5,5,5,5,5,1,1,1,1,1,1,1,-1,1,1,6,6
1,1,1,1,1,1,6,6,6,6,6,6,1,1,4,4,4,4,4,1,1,1,5,5,5,5,1,1,1,1,1,1,1,1,1,-1,1,6,6,6
1,1,1,1,6,6,6,1,1,1,1,6,6,6,1,1,4,4,1,1,1,1,1,1,1,1,6,6,6,6,1,1,1,1,1,-1,1,6,6,1
1,1,6,6,6,6,1,1,1,1,1,1,6,6,6,1,4,4,1,1,1,1,6,6,6,6,6,6,6,1,1,1,1,1,1,-1,1,6,1,1
1,1,6,1,1,1,1,1,1,1,1,4,4,4,6,6,4,4,1,1,1,6,6,6,6,6,6,1,1,1,1,1,1,-1,-1,-1,1,1,1,1
1,1,1,1,1,1,1,1,1,1,1,4,4,4,6,6,4,4,1,1,6,6,6,1,1,1,1,1,1,1,1,1,1,-1,1,1,1,1,1,1
1,1,1,1,1,1,1,1,1,1,4,4,4,4,1,6,1,1,1,1,6,6,1,1,1,1,1,1,1,1,1,-1,-1,-1,1,1,1,1,1,1
1,1,1,1,1,1,1,1,1,4,4,4,4,4,6,6,6,6,6,6,6,6,1,1,1,1,1,1,1,-1,-1,-1,1,1,1,1,1,1,1,1
1,1,1,4,4,1,1,4,4,4,4,4,4,4,6,6,6,6,6,6,6,6,6,6,1,1,1,1,-1,-1,1,1,1,-1,-1,-1,-1,-1,-1,1
1,1,1,1,4,1,1,4,4,4,4,4,4,4,1,1,1,6,6,6,6,6,6,6,1,1,1,1,-1,1,1,1,1,-1,1,1,1,1,1,1
1,1,1,1,4,1,1,1,1,4,4,4,4,4,1,1,1,1,1,1,1,1,6,6,6,6,1,1,-1,1,1,1,1,-1,-1,1,1,1,1,1
1,1,1,1,4,4,1,1,1,1,4,4,4,4,1,1,1,1,1,1,1,1,1,6,6,1,-1,-1,-1,1,1,1,1,1,-1,1,1,1,1,1
1,1,1,1,4,4,1,1,1,1,1,1,1,1,1,1,1,1,1,1,1,1,1,1,1,1,1,1,1,1,1,1,1,1,-1,1,1,1,1,1
1,1,1,1,4,4,-1,-1,-1,-1,-1,-1,-1,-1,-1,-1,-1,-1,-1,-1,-1,-1,-1,-1,-1,-1,-1,-1,-1,-1,-1,-1,-1,-1,-1,1,1,3,1,1
1,1,1,1,4,4,1,1,1,1,1,1,1,5,5,5,5,1,1,6,6,6,6,1,1,1,5,5,5,5,5,1,1,1,-1,-1,-1,-1,-1,1
1,1,1,1,1,4,1,1,1,1,1,1,1,1,1,1,1,1,1,1,1,1,1,1,1,1,1,1,1,1,1,1,1,1,1,1,1,1,1,1